WE ./sprites/wall1.xpm
EA ./sprites/wall2.xpm
NO ./sprites/wall3.xpm
SO ./sprites/wall8.xpm

F 0,75,73
C 142,200,216


11111111111111
10000000000001
10000000000001
10000000000001
10000000000001
10000000000001
10000000000001
100000000000P1
11111111111111
